21 47 47 47 47 47 47 47 47 47 47 47 47 47 47 47 47 47 47 47 47 47 66 67 66 67 66 67 66 67 20 16 8  10 9  10 8  16 61 62 21 8  8  8  9  9  10 25 25 26 26 27 27 27 27 27 25 25 35 36 36 36 16 16 16 16 16 16 16 16 16 16 16 16 16 16 16 16 66 67 21 16 8  8  10 25 26 27 25 14 13 4  4  6  3  7  8  9  8  9  8  9  4  7  1  51 9  6  5  1  1  6  1  1  3  1  6  2  1  78
22 1  4  4  2  75 3  24 9  12 4  6  7  27 27 25 8  9  8  9  9  8  6  1  1  9  10 3  1  1  1  1  7  1  5  1  1  1  1  77
2  1  1  2  3  3  3  10 10 9  7  1  2  16 9  9  8  8  9  9  10 10 4  6  7  16 8  3  2  1  5  1  4  3  7  4  7  2  5  78
21 9  16 10 10 16 10 9  10 10 1  5  4  7  4  10 10 10 10 10 10 10 16 16 16 52 16 8  15 15 9  24 53 53 16 16 9  10 3  78
21 26 25 10 9  8  24 24 8  8  2  3  6  2  1  9  10 10 10 10 10 10 16 16 8  16 51 8  9  9  8  24 52 52 8  10 10 14 4  78
21 25 25 10 3  1  2  5  8  8  10 8  1  3  1  9  10 10 10 15 8  8  1  6  1  7  3  4  3  10 9  1  61 62 8  16 5  3  1  76
76 27 26 16 7  1  7  6  16 8  9  8  5  1  5  10 9  9  10 51 52 9  1  2  3  5  3  1  2  10 8  1  66 67 8  54 2  1  6  75
74 25 27 49 3  1  1  1  16 8  10 8  2  7  6  16 8  9  10 24 24 8  8  8  4  4  1  7  1  16 16 1  1  1  16 52 1  1  1  79
75 31 27 49 4  5  5  1  16 8  10 8  3  5  6  16 8  9  10 28 29 24 16 16 16 16 8  1  74 10 10 1  1  1  16 16 4  5  7  21
21 31 48 9  1  2  1  4  16 8  10 8  1  1  2  9  8  9  10 30 31 8  16 16 16 16 8  7  3  24 54 1  1  1  10 8  1  4  1  21
21 24 49 10 4  4  1  5  16 8  10 8  4  1  1  8  9  8  10 20 11 16 5  1  5  16 16 3  1  9  10 1  1  1  16 10 3  5  1  21
11 24 49 10 5  7  4  5  16 8  10 8  2  1  2  10 8  25 10 8  53 52 4  1  3  16 16 1  5  9  10 1  1  1  10 9  3  2  1  21
9  24 49 10 4  7  3  2  16 8  10 8  3  4  1  8  8  25 10 16 16 16 4  5  1  16 16 2  6  10 10 1  1  1  10 9  1  1  4  21
8  24 49 10 7  6  1  3  25 8  10 8  6  5  4  8  8  24 10 16 16 16 1  1  1  16 16 1  6  9  10 76 1  1  8  10 7  3  1  21
8  24 49 10 6  1  6  1  26 8  10 8  10 10 4  9  24 24 10 8  16 16 4  6  4  16 16 4  20 15 15 1  1  1  9  16 5  1  7  21
16 24 49 10 6  3  3  7  9  9  8  9  10 10 1  24 14 13 10 27 16 16 1  7  1  8  8  51 57 24 25 1  1  1  8  16 7  7  1  16
62 54 49 10 6  5  2  6  8  8  9  8  9  9  2  24 12 11 24 10 25 16 1  1  1  52 51 56 52 25 24 1  1  1  9  8  1  1  1  16
67 54 49 12 7  1  2  7  8  9  8  8  22 22 7  24 25 25 24 10 25 16 7  5  3  2  5  6  2  3  2  1  1  1  9  8  2  1  5  16
61 62 49 12 5  1  4  4  9  9  9  9  23 23 1  24 24 24 25 10 25 16 3  3  1  1  2  4  1  7  1  1  1  1  10 16 1  3  4  16
66 67 49 12 3  4  2  1  8  8  8  9  22 23 5  25 25 26 27 10 26 26 16 16 16 16 16 16 16 16 16 16 16 16 16 16 16 16 16 16
47 47 47 47 47 47 47 47 47 47 47 47 47 47 47 47 47 47 47 47 47 47 47 47 47 47 47 47 47 47 47 47 47 47 47 47 47 47 47 47
